###_###
#_____#
#_##_##
#_##__#
#_#####
#_#####