###_###
#_____#
#_##_##
#_##__#
#E#####