###S###
#_____#
#_##_##
#_##__#
#E#####